num_vertices,edge_ratio,elapsed_time,weight,n_sol,n_oper
2,0.125,0.000273,0,2,4
2,0.25,0.000202,0,2,4
2,0.5,0.000165,0,2,4
2,0.75,0.00019,79,2,4
3,0.125,0.000211,0,3,6
3,0.25,0.000221,0,3,6
3,0.5,0.000168,86,3,6
3,0.75,0.000264,175,3,6
4,0.125,0.000185,0,4,8
4,0.25,0.000479,0,4,8
4,0.5,0.000357,138,4,8
4,0.75,0.000498,251,4,8
5,0.125,0.000297,0,5,10
5,0.25,0.000223,0,5,10
5,0.5,0.000224,235,5,10
5,0.75,0.000199,327,5,10
6,0.125,0.000374,0,6,12
6,0.25,0.00028,0,6,12
6,0.5,0.000671,258,6,12
6,0.75,0.000687,468,6,12
7,0.125,0.000367,69,7,14
7,0.25,0.000549,73,7,14
7,0.5,0.000315,277,7,14
7,0.75,0.000269,529,7,14
8,0.125,0.00025,53,8,16
8,0.25,0.000216,100,8,16
8,0.5,0.000477,381,8,16
8,0.75,0.000378,591,8,16
9,0.125,0.000268,95,9,18
9,0.25,0.000224,193,9,18
9,0.5,0.000299,753,9,18
9,0.75,0.000334,855,9,18
10,0.125,0.000422,176,10,20
10,0.25,0.000348,290,10,20
10,0.5,0.000321,604,10,20
10,0.75,0.000384,927,10,20
11,0.125,0.000262,229,11,22
11,0.25,0.00046,495,11,22
11,0.5,0.000555,1068,11,22
11,0.75,0.000469,1386,11,22
12,0.125,0.000291,378,12,24
12,0.25,0.000339,734,12,24
12,0.5,0.000549,1310,12,24
12,0.75,0.000905,1481,12,24
13,0.125,0.000506,436,13,26
13,0.25,0.000382,432,13,26
13,0.5,0.000492,1315,13,26
13,0.75,0.001448,1733,13,26
14,0.125,0.00048,484,14,28
14,0.25,0.000456,698,14,28
14,0.5,0.000702,1500,14,28
14,0.75,0.000703,1787,14,28
15,0.125,0.000426,517,15,30
15,0.25,0.000641,982,15,30
15,0.5,0.000711,1715,15,30
15,0.75,0.000704,2643,15,30
16,0.125,0.000452,576,16,32
16,0.25,0.001226,1066,16,32
16,0.5,0.000672,1929,16,32
16,0.75,0.000835,2944,16,32
17,0.125,0.000525,665,17,34
17,0.25,0.000549,1148,17,34
17,0.5,0.00082,2440,17,34
17,0.75,0.001406,2860,17,34
18,0.125,0.000866,607,18,36
18,0.25,0.000541,1323,18,36
18,0.5,0.001964,2517,18,36
18,0.75,0.001038,3094,18,36
19,0.125,0.00055,1006,19,38
19,0.25,0.001447,1380,19,38
19,0.5,0.001134,2676,19,38
19,0.75,0.001212,3297,19,38
20,0.125,0.000769,880,20,40
20,0.25,0.000817,1460,20,40
20,0.5,0.001704,2612,20,40
20,0.75,0.001361,3519,20,40
21,0.125,0.000562,904,21,42
21,0.25,0.001195,1370,21,42
21,0.5,0.001065,2983,21,42
21,0.75,0.001658,4276,21,42
22,0.125,0.000635,894,22,44
22,0.25,0.000737,1703,22,44
22,0.5,0.001423,3467,22,44
22,0.75,0.001629,5145,22,44
23,0.125,0.001347,974,23,46
23,0.25,0.000933,1786,23,46
23,0.5,0.001634,3643,23,46
23,0.75,0.001841,5170,23,46
24,0.125,0.001333,1081,24,48
24,0.25,0.001299,1688,24,48
24,0.5,0.002126,3856,24,48
24,0.75,0.001808,5434,24,48
25,0.125,0.000958,1480,25,50
25,0.25,0.001011,2652,25,50
25,0.5,0.00229,4511,25,50
25,0.75,0.00252,6265,25,50
26,0.125,0.000916,1579,26,52
26,0.25,0.001178,1992,26,52
26,0.5,0.003093,4399,26,52
26,0.75,0.002637,6750,26,52
27,0.125,0.001069,1622,27,54
27,0.25,0.003442,2791,27,54
27,0.5,0.00295,5499,27,54
27,0.75,0.003906,7092,27,54
28,0.125,0.001261,1992,28,56
28,0.25,0.001492,2659,28,56
28,0.5,0.002657,5563,28,56
28,0.75,0.00328,7694,28,56
29,0.125,0.001154,2059,29,58
29,0.25,0.003,2837,29,58
29,0.5,0.002736,6088,29,58
29,0.75,0.003656,8404,29,58
30,0.125,0.001092,2065,30,60
30,0.25,0.00159,3343,30,60
30,0.5,0.004127,6414,30,60
30,0.75,0.004352,9030,30,60
31,0.125,0.001302,2241,31,62
31,0.25,0.002358,3182,31,62
31,0.5,0.00274,6856,31,62
31,0.75,0.003836,9037,31,62
32,0.125,0.001225,2178,32,64
32,0.25,0.002698,3841,32,64
32,0.5,0.004929,7566,32,64
32,0.75,0.004325,10706,32,64
33,0.125,0.001392,2181,33,66
33,0.25,0.003031,4031,33,66
33,0.5,0.004202,8114,33,66
33,0.75,0.004574,10473,33,66
34,0.125,0.00224,3039,34,68
34,0.25,0.002336,4679,34,68
34,0.5,0.003941,8801,34,68
34,0.75,0.008092,11800,34,68
35,0.125,0.003493,2621,35,70
35,0.25,0.006524,4423,35,70
35,0.5,0.004826,8731,35,70
35,0.75,0.006218,11954,35,70
36,0.125,0.001817,2557,36,72
36,0.25,0.002812,3626,36,72
36,0.5,0.004288,9487,36,72
36,0.75,0.005692,13100,36,72
37,0.125,0.001774,3172,37,74
37,0.25,0.002747,5543,37,74
37,0.5,0.006366,10696,37,74
37,0.75,0.006228,13408,37,74
38,0.125,0.002048,3641,38,76
38,0.25,0.002553,5537,38,76
38,0.5,0.005555,10311,38,76
38,0.75,0.007357,13866,38,76
39,0.125,0.001919,3262,39,78
39,0.25,0.002833,6066,39,78
39,0.5,0.005152,11292,39,78
39,0.75,0.011892,15453,39,78
40,0.125,0.002576,3865,40,80
40,0.25,0.003591,6109,40,80
40,0.5,0.005691,11524,40,80
40,0.75,0.007123,16114,40,80
41,0.125,0.003413,4095,41,82
41,0.25,0.004049,6678,41,82
41,0.5,0.007017,12322,41,82
41,0.75,0.008943,17327,41,82
42,0.125,0.0054,4540,42,84
42,0.25,0.005116,6415,42,84
42,0.5,0.008859,12100,42,84
42,0.75,0.011811,17095,42,84
43,0.125,0.003219,4886,43,86
43,0.25,0.005077,7766,43,86
43,0.5,0.00776,12321,43,86
43,0.75,0.00987,17231,43,86
44,0.125,0.003012,4051,44,88
44,0.25,0.005179,7028,44,88
44,0.5,0.008025,12714,44,88
44,0.75,0.011638,19387,44,88
45,0.125,0.00291,3889,45,90
45,0.25,0.00619,7425,45,90
45,0.5,0.008199,15245,45,90
45,0.75,0.012205,20234,45,90
46,0.125,0.004186,4154,46,92
46,0.25,0.004204,7726,46,92
46,0.5,0.009871,14184,46,92
46,0.75,0.012371,19070,46,92
47,0.125,0.004243,4606,47,94
47,0.25,0.006514,8306,47,94
47,0.5,0.009647,14981,47,94
47,0.75,0.013527,22052,47,94
48,0.125,0.002966,5106,48,96
48,0.25,0.006361,9296,48,96
48,0.5,0.009551,15737,48,96
48,0.75,0.012262,22512,48,96
49,0.125,0.003382,4761,49,98
49,0.25,0.007479,8422,49,98
49,0.5,0.012533,17284,49,98
49,0.75,0.013433,22571,49,98
50,0.125,0.004126,4902,50,100
50,0.25,0.006529,8896,50,100
50,0.5,0.010006,16289,50,100
50,0.75,0.014745,24390,50,100
51,0.125,0.003968,5732,51,102
51,0.25,0.008407,10072,51,102
51,0.5,0.016075,18534,51,102
51,0.75,0.028952,24543,51,102
52,0.125,0.004466,6364,52,104
52,0.25,0.007041,10875,52,104
52,0.5,0.01577,17910,52,104
52,0.75,0.018356,26085,52,104
53,0.125,0.005266,6033,53,106
53,0.25,0.009852,10860,53,106
53,0.5,0.011144,19804,53,106
53,0.75,0.015919,28032,53,106
54,0.125,0.005048,6124,54,108
54,0.25,0.008938,10779,54,108
54,0.5,0.017244,19630,54,108
54,0.75,0.017497,28561,54,108
55,0.125,0.004367,5941,55,110
55,0.25,0.008556,12513,55,110
55,0.5,0.014472,21851,55,110
55,0.75,0.017806,30845,55,110
56,0.125,0.004799,6406,56,112
56,0.25,0.007991,12719,56,112
56,0.5,0.012913,22317,56,112
56,0.75,0.019545,30713,56,112
57,0.125,0.014166,7594,57,114
57,0.25,0.007762,13250,57,114
57,0.5,0.013921,22077,57,114
57,0.75,0.022103,31794,57,114
58,0.125,0.004957,6698,58,116
58,0.25,0.008209,13330,58,116
58,0.5,0.020568,21883,58,116
58,0.75,0.021797,33432,58,116
59,0.125,0.007231,7241,59,118
59,0.25,0.015646,12753,59,118
59,0.5,0.015884,24437,59,118
59,0.75,0.029173,33555,59,118
60,0.125,0.007411,8830,60,120
60,0.25,0.010378,13209,60,120
60,0.5,0.017972,25272,60,120
60,0.75,0.021976,36023,60,120
61,0.125,0.006379,7283,61,122
61,0.25,0.008952,14144,61,122
61,0.5,0.018419,25477,61,122
61,0.75,0.025687,36769,61,122
62,0.125,0.005675,7788,62,124
62,0.25,0.009065,15428,62,124
62,0.5,0.018401,26889,62,124
62,0.75,0.024002,36055,62,124
63,0.125,0.007603,9314,63,126
63,0.25,0.013278,14935,63,126
63,0.5,0.023282,26174,63,126
63,0.75,0.036758,38596,63,126
64,0.125,0.006638,8542,64,128
64,0.25,0.011932,14433,64,128
64,0.5,0.022695,28708,64,128
64,0.75,0.032974,40545,64,128
65,0.125,0.008009,8778,65,130
65,0.25,0.013243,15350,65,130
65,0.5,0.021613,28846,65,130
65,0.75,0.027846,41872,65,130
66,0.125,0.006898,9649,66,132
66,0.25,0.015509,16663,66,132
66,0.5,0.025911,30626,66,132
66,0.75,0.032343,44919,66,132
67,0.125,0.006868,9413,67,134
67,0.25,0.012419,17344,67,134
67,0.5,0.028179,31196,67,134
67,0.75,0.032658,42619,67,134
68,0.125,0.008755,9801,68,136
68,0.25,0.011162,16895,68,136
68,0.5,0.024903,32006,68,136
68,0.75,0.043985,44148,68,136
69,0.125,0.0094,10089,69,138
69,0.25,0.014264,16964,69,138
69,0.5,0.026069,32830,69,138
69,0.75,0.040544,47014,69,138
70,0.125,0.009051,10732,70,140
70,0.25,0.015446,18877,70,140
70,0.5,0.028186,32332,70,140
70,0.75,0.045202,50548,70,140
71,0.125,0.010907,10299,71,142
71,0.25,0.018592,19992,71,142
71,0.5,0.036568,33157,71,142
71,0.75,0.036349,50228,71,142
72,0.125,0.010221,11650,72,144
72,0.25,0.032232,19646,72,144
72,0.5,0.03135,33617,72,144
72,0.75,0.044601,51982,72,144
73,0.125,0.008756,10582,73,146
73,0.25,0.017527,21037,73,146
73,0.5,0.033881,37335,73,146
73,0.75,0.048618,52832,73,146
74,0.125,0.008678,11760,74,148
74,0.25,0.025255,21182,74,148
74,0.5,0.040575,38626,74,148
74,0.75,0.046955,54496,74,148
75,0.125,0.012271,12261,75,150
75,0.25,0.021621,21198,75,150
75,0.5,0.034138,36455,75,150
75,0.75,0.046824,54412,75,150
76,0.125,0.009255,12464,76,152
76,0.25,0.019334,22847,76,152
76,0.5,0.033615,38121,76,152
76,0.75,0.0446,56130,76,152
77,0.125,0.011035,11303,77,154
77,0.25,0.024371,21741,77,154
77,0.5,0.039498,40507,77,154
77,0.75,0.046203,57464,77,154
78,0.125,0.012912,12530,78,156
78,0.25,0.027013,22376,78,156
78,0.5,0.038922,39974,78,156
78,0.75,0.056916,57556,78,156
79,0.125,0.010441,12582,79,158
79,0.25,0.026428,23632,79,158
79,0.5,0.045424,41775,79,158
79,0.75,0.051579,63126,79,158
80,0.125,0.0145,12750,80,160
80,0.25,0.02532,23288,80,160
80,0.5,0.048326,42276,80,160
80,0.75,0.072371,62771,80,160
81,0.125,0.010818,12447,81,162
81,0.25,0.02408,25683,81,162
81,0.5,0.038793,44118,81,162
81,0.75,0.055992,65002,81,162
82,0.125,0.017411,12978,82,164
82,0.25,0.030966,24000,82,164
82,0.5,0.060693,45488,82,164
82,0.75,0.080606,66798,82,164
83,0.125,0.019237,12838,83,166
83,0.25,0.032508,24969,83,166
83,0.5,0.04884,44988,83,166
83,0.75,0.070855,68115,83,166
84,0.125,0.014112,13355,84,168
84,0.25,0.031099,26004,84,168
84,0.5,0.05675,49222,84,168
84,0.75,0.068086,68233,84,168
85,0.125,0.014313,12634,85,170
85,0.25,0.027342,25986,85,170
85,0.5,0.042416,47811,85,170
85,0.75,0.069466,69615,85,170
86,0.125,0.014516,13592,86,172
86,0.25,0.042449,27036,86,172
86,0.5,0.075129,47616,86,172
86,0.75,0.11963,70844,86,172
87,0.125,0.036892,14223,87,174
87,0.25,0.044225,27517,87,174
87,0.5,0.063685,51723,87,174
87,0.75,0.094248,73386,87,174
88,0.125,0.014892,14333,88,176
88,0.25,0.030852,28013,88,176
88,0.5,0.056904,53279,88,176
88,0.75,0.085525,75600,88,176
89,0.125,0.020124,16736,89,178
89,0.25,0.033358,29552,89,178
89,0.5,0.098648,52417,89,178
89,0.75,0.117835,78618,89,178
90,0.125,0.019446,14811,90,180
90,0.25,0.034235,31364,90,180
90,0.5,0.092869,53637,90,180
90,0.75,0.139628,78951,90,180
91,0.125,0.025629,16742,91,182
91,0.25,0.045643,31017,91,182
91,0.5,0.080842,57678,91,182
91,0.75,0.154949,82391,91,182
92,0.125,0.026009,14525,92,184
92,0.25,0.085361,30596,92,184
92,0.5,0.123442,57094,92,184
92,0.75,0.11795,82978,92,184
93,0.125,0.028092,16963,93,186
93,0.25,0.038712,30287,93,186
93,0.5,0.064373,60500,93,186
93,0.75,0.086721,84657,93,186
94,0.125,0.024995,15707,94,188
94,0.25,0.044514,31314,94,188
94,0.5,0.091453,60539,94,188
94,0.75,0.118715,85996,94,188
95,0.125,0.02455,17544,95,190
95,0.25,0.040555,32825,95,190
95,0.5,0.082124,58604,95,190
95,0.75,0.15521,90207,95,190
96,0.125,0.041517,17505,96,192
96,0.25,0.099816,32094,96,192
96,0.5,0.106691,63409,96,192
96,0.75,0.20911,90667,96,192
97,0.125,0.026643,17506,97,194
97,0.25,0.069753,34115,97,194
97,0.5,0.105984,62152,97,194
97,0.75,0.131451,89632,97,194
98,0.125,0.032613,17865,98,196
98,0.25,0.057502,32948,98,196
98,0.5,0.083696,63703,98,196
98,0.75,0.137855,91632,98,196
99,0.125,0.029429,17184,99,198
99,0.25,0.047167,36676,99,198
99,0.5,0.09021,68005,99,198
99,0.75,0.114611,94815,99,198
100,0.125,0.026515,19385,100,200
100,0.25,0.052364,36148,100,200
100,0.5,0.083814,67474,100,200
100,0.75,0.122467,99233,100,200
101,0.125,0.032424,18238,101,202
101,0.25,0.050015,35645,101,202
101,0.5,0.094624,68776,101,202
101,0.75,0.121383,96850,101,202
102,0.125,0.025233,21403,102,204
102,0.25,0.041678,36344,102,204
102,0.5,0.099951,69310,102,204
102,0.75,0.097284,98963,102,204
103,0.125,0.024117,19750,103,206
103,0.25,0.042942,37786,103,206
103,0.5,0.077077,72687,103,206
103,0.75,0.107944,104903,103,206
104,0.125,0.022203,20450,104,208
104,0.25,0.043715,38551,104,208
104,0.5,0.074491,72897,104,208
104,0.75,0.127033,104722,104,208
105,0.125,0.036,21133,105,210
105,0.25,0.063282,37999,105,210
105,0.5,0.086971,71849,105,210
105,0.75,0.143357,105282,105,210
106,0.125,0.035323,21483,106,212
106,0.25,0.044909,39719,106,212
106,0.5,0.08452,74057,106,212
106,0.75,0.123527,106042,106,212
107,0.125,0.022081,21117,107,214
107,0.25,0.044017,41113,107,214
107,0.5,0.082508,77821,107,214
107,0.75,0.121527,110203,107,214
108,0.125,0.024629,21311,108,216
108,0.25,0.042004,41830,108,216
108,0.5,0.081117,77302,108,216
108,0.75,0.121195,109845,108,216
109,0.125,0.025369,21258,109,218
109,0.25,0.039241,41895,109,218
109,0.5,0.075771,80017,109,218
109,0.75,0.109658,115208,109,218
110,0.125,0.025734,22660,110,220
110,0.25,0.044656,42977,110,220
110,0.5,0.085129,80186,110,220
110,0.75,0.113703,118349,110,220
111,0.125,0.023813,22508,111,222
111,0.25,0.066575,41617,111,222
111,0.5,0.0929,81533,111,222
111,0.75,0.14119,119744,111,222
112,0.125,0.024007,24331,112,224
112,0.25,0.046362,45322,112,224
112,0.5,0.085333,82988,112,224
112,0.75,0.13437,120269,112,224
113,0.125,0.028139,24179,113,226
113,0.25,0.050602,42374,113,226
113,0.5,0.121348,83101,113,226
113,0.75,0.11894,125503,113,226
114,0.125,0.02627,23621,114,228
114,0.25,0.067774,45430,114,228
114,0.5,0.085652,86281,114,228
114,0.75,0.185315,125457,114,228
115,0.125,0.028149,23816,115,230
115,0.25,0.050037,46961,115,230
115,0.5,0.10392,86087,115,230
115,0.75,0.159964,126948,115,230
116,0.125,0.041188,25436,116,232
116,0.25,0.078442,46373,116,232
116,0.5,0.122674,86726,116,232
116,0.75,0.146096,129140,116,232
117,0.125,0.027812,26362,117,234
117,0.25,0.075367,49811,117,234
117,0.5,0.118078,88856,117,234
117,0.75,0.184566,129815,117,234
118,0.125,0.031113,25838,118,236
118,0.25,0.072312,49925,118,236
118,0.5,0.104989,93225,118,236
118,0.75,0.15651,134083,118,236
119,0.125,0.036693,25493,119,238
119,0.25,0.060138,50207,119,238
119,0.5,0.121236,93170,119,238
119,0.75,0.202356,138071,119,238
120,0.125,0.029715,25892,120,240
120,0.25,0.053119,50549,120,240
120,0.5,0.100599,94540,120,240
120,0.75,0.209254,139324,120,240
121,0.125,0.039168,28102,121,242
121,0.25,0.058042,50777,121,242
121,0.5,0.102134,96989,121,242
121,0.75,0.152749,141790,121,242
122,0.125,0.032188,27893,122,244
122,0.25,0.062683,51001,122,244
122,0.5,0.108191,97193,122,244
122,0.75,0.162078,147099,122,244
123,0.125,0.065716,28128,123,246
123,0.25,0.082674,55241,123,246
123,0.5,0.132872,102365,123,246
123,0.75,0.191076,146817,123,246
124,0.125,0.033445,28247,124,248
124,0.25,0.08289,56441,124,248
124,0.5,0.128915,101303,124,248
124,0.75,0.174307,148035,124,248
125,0.125,0.040279,27829,125,250
125,0.25,0.071405,53432,125,250
125,0.5,0.14073,101417,125,250
125,0.75,0.172563,145863,125,250
126,0.125,0.033498,28982,126,252
126,0.25,0.091672,55607,126,252
126,0.5,0.122696,103545,126,252
126,0.75,0.185519,150811,126,252
127,0.125,0.041786,29543,127,254
127,0.25,0.07376,55651,127,254
127,0.5,0.133401,106144,127,254
127,0.75,0.189928,153794,127,254
128,0.125,0.075024,29567,128,256
128,0.25,0.081618,57602,128,256
128,0.5,0.137153,106996,128,256
128,0.75,0.203528,157459,128,256
129,0.125,0.053217,29158,129,258
129,0.25,0.087317,57425,129,258
129,0.5,0.126132,110459,129,258
129,0.75,0.214458,161971,129,258
130,0.125,0.041212,30796,130,260
130,0.25,0.078755,57643,130,260
130,0.5,0.133287,109163,130,260
130,0.75,0.217514,161217,130,260
131,0.125,0.039242,31119,131,262
131,0.25,0.078043,58292,131,262
131,0.5,0.13486,114074,131,262
131,0.75,0.330871,162518,131,262
132,0.125,0.072796,34286,132,264
132,0.25,0.132563,61207,132,264
132,0.5,0.178072,112646,132,264
132,0.75,0.234884,168133,132,264
133,0.125,0.045404,32900,133,266
133,0.25,0.124514,61854,133,266
133,0.5,0.168396,113459,133,266
133,0.75,0.215031,169505,133,266
134,0.125,0.063943,31818,134,268
134,0.25,0.079301,60827,134,268
134,0.5,0.145045,115848,134,268
134,0.75,0.214561,172225,134,268
135,0.125,0.047686,33334,135,270
135,0.25,0.078665,60928,135,270
135,0.5,0.166212,117067,135,270
135,0.75,0.227429,178128,135,270
136,0.125,0.045446,32321,136,272
136,0.25,0.07526,64365,136,272
136,0.5,0.138765,115836,136,272
136,0.75,0.24564,177359,136,272
137,0.125,0.048342,33568,137,274
137,0.25,0.100562,63219,137,274
137,0.5,0.150835,119938,137,274
137,0.75,0.217763,180756,137,274
138,0.125,0.045449,34705,138,276
138,0.25,0.106031,63969,138,276
138,0.5,0.147805,124209,138,276
138,0.75,0.241496,179744,138,276
139,0.125,0.043507,36092,139,278
139,0.25,0.088865,65819,139,278
139,0.5,0.16762,127239,139,278
139,0.75,0.255142,189692,139,278
140,0.125,0.049367,35444,140,280
140,0.25,0.08218,64186,140,280
140,0.5,0.157097,125434,140,280
140,0.75,0.250476,187712,140,280
141,0.125,0.043875,35004,141,282
141,0.25,0.091664,67564,141,282
141,0.5,0.165577,127989,141,282
141,0.75,0.250351,189491,141,282
142,0.125,0.044945,37656,142,284
142,0.25,0.087923,66345,142,284
142,0.5,0.177058,128450,142,284
142,0.75,0.283588,192436,142,284
143,0.125,0.047032,36663,143,286
143,0.25,0.096104,68352,143,286
143,0.5,0.178832,131790,143,286
143,0.75,0.273585,195685,143,286
144,0.125,0.051057,36602,144,288
144,0.25,0.097098,68987,144,288
144,0.5,0.183329,134711,144,288
144,0.75,0.241668,197966,144,288
145,0.125,0.050437,38533,145,290
145,0.25,0.099837,70894,145,290
145,0.5,0.192977,134423,145,290
145,0.75,0.275272,201744,145,290
146,0.125,0.054569,37334,146,292
146,0.25,0.108015,71014,146,292
146,0.5,0.199302,136368,146,292
146,0.75,0.302916,203560,146,292
147,0.125,0.053682,37210,147,294
147,0.25,0.106555,71563,147,294
147,0.5,0.194954,141126,147,294
147,0.75,0.302647,200943,147,294
148,0.125,0.051686,38130,148,296
148,0.25,0.105886,71690,148,296
148,0.5,0.194681,142378,148,296
148,0.75,0.257192,212286,148,296
149,0.125,0.059305,40025,149,298
149,0.25,0.102818,75949,149,298
149,0.5,0.211341,145222,149,298
149,0.75,0.304903,211062,149,298
150,0.125,0.052707,39659,150,300
150,0.25,0.112118,73537,150,300
150,0.5,0.212817,146314,150,300
150,0.75,0.304361,214575,150,300
151,0.125,0.059459,39184,151,302
151,0.25,0.118607,75660,151,302
151,0.5,0.205503,147145,151,302
151,0.75,0.308026,218268,151,302
152,0.125,0.061817,40219,152,304
152,0.25,0.112618,76969,152,304
152,0.5,0.204686,147929,152,304
152,0.75,0.281775,223256,152,304
153,0.125,0.055515,41929,153,306
153,0.25,0.105303,81127,153,306
153,0.5,0.224714,149289,153,306
153,0.75,0.286958,225107,153,306
154,0.125,0.059427,43224,154,308
154,0.25,0.119023,80248,154,308
154,0.5,0.240025,158564,154,308
154,0.75,0.295165,228269,154,308
155,0.125,0.061247,42561,155,310
155,0.25,0.106893,80239,155,310
155,0.5,0.222133,158506,155,310
155,0.75,0.331086,229636,155,310
156,0.125,0.057681,42412,156,312
156,0.25,0.127146,83080,156,312
156,0.5,0.262394,155658,156,312
156,0.75,0.333686,233784,156,312
157,0.125,0.070046,44210,157,314
157,0.25,0.1324,81600,157,314
157,0.5,0.223705,159297,157,314
157,0.75,0.312575,236660,157,314
158,0.125,0.063785,41515,158,316
158,0.25,0.115463,80947,158,316
158,0.5,0.241397,159549,158,316
158,0.75,0.349832,239931,158,316
159,0.125,0.071256,44283,159,318
159,0.25,0.115042,81387,159,318
159,0.5,0.219532,164820,159,318
159,0.75,0.343405,240580,159,318
160,0.125,0.070321,44872,160,320
160,0.25,0.134991,86244,160,320
160,0.5,0.229101,164626,160,320
160,0.75,0.334941,244424,160,320
161,0.125,0.064508,46409,161,322
161,0.25,0.139389,88372,161,322
161,0.5,0.235738,167052,161,322
161,0.75,0.342685,244862,161,322
162,0.125,0.063492,45026,162,324
162,0.25,0.136745,88633,162,324
162,0.5,0.25358,167938,162,324
162,0.75,0.36842,248163,162,324
163,0.125,0.110219,47219,163,326
163,0.25,0.128104,88170,163,326
163,0.5,0.283277,172683,163,326
163,0.75,0.341046,253532,163,326
164,0.125,0.068794,46289,164,328
164,0.25,0.148243,89635,164,328
164,0.5,0.276605,177670,164,328
164,0.75,0.369213,260056,164,328
165,0.125,0.075004,47109,165,330
165,0.25,0.132123,91802,165,330
165,0.5,0.248513,175616,165,330
165,0.75,0.356419,261535,165,330
166,0.125,0.075183,47626,166,332
166,0.25,0.135992,91434,166,332
166,0.5,0.292721,179459,166,332
166,0.75,0.448541,263589,166,332
167,0.125,0.077248,49643,167,334
167,0.25,0.155903,90071,167,334
167,0.5,0.285757,177348,167,334
167,0.75,0.369062,266985,167,334
168,0.125,0.071462,51123,168,336
168,0.25,0.141631,94312,168,336
168,0.5,0.25351,184411,168,336
168,0.75,0.415538,274953,168,336
169,0.125,0.079384,49680,169,338
169,0.25,0.150027,95611,169,338
169,0.5,0.293649,183217,169,338
169,0.75,0.405187,274851,169,338
170,0.125,0.075785,52766,170,340
170,0.25,0.1581,98414,170,340
170,0.5,0.314073,191109,170,340
170,0.75,0.444055,270767,170,340
171,0.125,0.076454,51968,171,342
171,0.25,0.167485,98742,171,342
171,0.5,0.286471,191854,171,342
171,0.75,0.443765,284127,171,342
172,0.125,0.091741,50719,172,344
172,0.25,0.170796,100365,172,344
172,0.5,0.307999,195438,172,344
172,0.75,0.412713,278799,172,344
173,0.125,0.085134,50960,173,346
173,0.25,0.147639,96099,173,346
173,0.5,0.335168,195483,173,346
173,0.75,0.466422,288292,173,346
174,0.125,0.089363,54697,174,348
174,0.25,0.168878,99722,174,348
174,0.5,0.314584,196997,174,348
174,0.75,0.506525,284822,174,348
175,0.125,0.102467,54055,175,350
175,0.25,0.19017,103374,175,350
175,0.5,0.351942,200777,175,350
175,0.75,0.562252,296556,175,350
176,0.125,0.104341,56300,176,352
176,0.25,0.186612,105020,176,352
176,0.5,0.361796,201754,176,352
176,0.75,0.476147,298445,176,352
177,0.125,0.110322,54351,177,354
177,0.25,0.219356,104290,177,354
177,0.5,0.351087,207496,177,354
177,0.75,0.524601,301955,177,354
178,0.125,0.10601,56751,178,356
178,0.25,0.196609,104159,178,356
178,0.5,0.375754,204472,178,356
178,0.75,0.529219,301727,178,356
179,0.125,0.107244,56328,179,358
179,0.25,0.208068,106184,179,358
179,0.5,0.407557,212563,179,358
179,0.75,0.513269,307906,179,358
180,0.125,0.102717,56997,180,360
180,0.25,0.217045,110668,180,360
180,0.5,0.405379,214447,180,360
180,0.75,0.617289,314187,180,360
181,0.125,0.131258,57140,181,362
181,0.25,0.19467,110415,181,362
181,0.5,0.391823,214563,181,362
181,0.75,0.481949,312364,181,362
182,0.125,0.100392,57747,182,364
182,0.25,0.177759,110992,182,364
182,0.5,0.362638,219097,182,364
182,0.75,0.482876,315417,182,364
183,0.125,0.094663,56645,183,366
183,0.25,0.198805,115291,183,366
183,0.5,0.363546,219113,183,366
183,0.75,0.494365,322319,183,366
184,0.125,0.102172,58358,184,368
184,0.25,0.183172,112687,184,368
184,0.5,0.3569,219884,184,368
184,0.75,0.565338,323487,184,368
185,0.125,0.106057,59098,185,370
185,0.25,0.203076,114226,185,370
185,0.5,0.378703,221095,185,370
185,0.75,0.520255,327440,185,370
186,0.125,0.10439,59730,186,372
186,0.25,0.208422,110161,186,372
186,0.5,0.353104,226546,186,372
186,0.75,0.568977,332745,186,372
187,0.125,0.09725,62180,187,374
187,0.25,0.185649,116233,187,374
187,0.5,0.401432,229334,187,374
187,0.75,0.575049,339001,187,374
188,0.125,0.116487,62489,188,376
188,0.25,0.204313,118214,188,376
188,0.5,0.386887,234275,188,376
188,0.75,0.523397,340760,188,376
189,0.125,0.11277,64001,189,378
189,0.25,0.207228,117446,189,378
189,0.5,0.363753,230106,189,378
189,0.75,0.589718,341740,189,378
190,0.125,0.139533,62959,190,380
190,0.25,0.194108,119827,190,380
190,0.5,0.489555,232797,190,380
190,0.75,0.567315,344529,190,380
191,0.125,0.113802,68241,191,382
191,0.25,0.217134,117542,191,382
191,0.5,0.376988,237348,191,382
191,0.75,0.612479,352313,191,382
192,0.125,0.112273,63870,192,384
192,0.25,0.203441,123398,192,384
192,0.5,0.40561,240034,192,384
192,0.75,0.560168,355301,192,384
193,0.125,0.123567,63847,193,386
193,0.25,0.238517,122299,193,386
193,0.5,0.38812,242614,193,386
193,0.75,0.618418,356272,193,386
194,0.125,0.125101,66313,194,388
194,0.25,0.213072,125813,194,388
194,0.5,0.392701,245001,194,388
194,0.75,0.611761,360771,194,388
195,0.125,0.123539,67050,195,390
195,0.25,0.259402,126540,195,390
195,0.5,0.462562,246992,195,390
195,0.75,0.634625,363867,195,390
196,0.125,0.125683,70662,196,392
196,0.25,0.246586,129645,196,392
196,0.5,0.4071,245616,196,392
196,0.75,0.634576,364850,196,392
197,0.125,0.127225,69021,197,394
197,0.25,0.231305,129830,197,394
197,0.5,0.496923,250903,197,394
197,0.75,0.654309,372500,197,394
198,0.125,0.121062,68107,198,396
198,0.25,0.213471,130748,198,396
198,0.5,0.421117,257648,198,396
198,0.75,0.78679,376371,198,396
199,0.125,0.134105,72346,199,398
199,0.25,0.233867,129646,199,398
199,0.5,0.441736,264558,199,398
199,0.75,0.682515,375021,199,398
200,0.125,0.153222,69619,200,400
200,0.25,0.246925,128508,200,400
200,0.5,0.454445,263679,200,400
200,0.75,0.644852,383812,200,400
201,0.125,0.137432,68918,201,402
201,0.25,0.229894,130678,201,402
201,0.5,0.465478,262226,201,402
201,0.75,0.766169,389165,201,402
202,0.125,0.133043,67827,202,404
202,0.25,0.267211,137821,202,404
202,0.5,0.494052,268113,202,404
202,0.75,0.727277,391526,202,404
203,0.125,0.130775,73152,203,406
203,0.25,0.273647,135401,203,406
203,0.5,0.499266,266971,203,406
203,0.75,0.779366,392284,203,406
204,0.125,0.125402,75130,204,408
204,0.25,0.25421,136298,204,408
204,0.5,0.53552,273726,204,408
204,0.75,0.697707,400284,204,408
205,0.125,0.127302,72919,205,410
205,0.25,0.242991,137930,205,410
205,0.5,0.482557,273335,205,410
205,0.75,0.700083,405640,205,410
206,0.125,0.150735,74662,206,412
206,0.25,0.249024,141323,206,412
206,0.5,0.599069,275026,206,412
206,0.75,0.826256,407561,206,412
207,0.125,0.135136,73724,207,414
207,0.25,0.26364,146483,207,414
207,0.5,0.564944,277708,207,414
207,0.75,0.714001,409653,207,414
208,0.125,0.140825,74204,208,416
208,0.25,0.277893,142890,208,416
208,0.5,0.614342,282191,208,416
208,0.75,0.8619,417063,208,416
209,0.125,0.279231,76696,209,418
209,0.25,0.268388,144762,209,418
209,0.5,0.518568,284157,209,418
209,0.75,0.723624,417758,209,418
210,0.125,0.182853,76572,210,420
210,0.25,0.262881,148411,210,420
210,0.5,0.536438,290965,210,420
210,0.75,0.86788,424355,210,420
211,0.125,0.157216,76489,211,422
211,0.25,0.292941,146033,211,422
211,0.5,0.510255,284949,211,422
211,0.75,0.743108,424920,211,422
212,0.125,0.155181,79712,212,424
212,0.25,0.283749,148325,212,424
212,0.5,0.582858,294050,212,424
212,0.75,0.776746,434610,212,424
213,0.125,0.162965,78892,213,426
213,0.25,0.294514,148648,213,426
213,0.5,0.580455,295933,213,426
213,0.75,0.834289,435175,213,426
214,0.125,0.155477,77897,214,428
214,0.25,0.306349,153441,214,428
214,0.5,0.51916,297485,214,428
214,0.75,0.774131,445204,214,428
215,0.125,0.160248,81657,215,430
215,0.25,0.314051,151700,215,430
215,0.5,0.63077,298141,215,430
215,0.75,0.90884,443334,215,430
216,0.125,0.161464,81870,216,432
216,0.25,0.287771,153768,216,432
216,0.5,0.52866,306613,216,432
216,0.75,0.876095,449686,216,432
217,0.125,0.148302,80906,217,434
217,0.25,0.305432,156206,217,434
217,0.5,0.713854,305077,217,434
217,0.75,0.810083,450572,217,434
218,0.125,0.173009,84736,218,436
218,0.25,0.325975,157576,218,436
218,0.5,0.635409,303643,218,436
218,0.75,0.881163,454815,218,436
219,0.125,0.172777,83109,219,438
219,0.25,0.332442,158059,219,438
219,0.5,0.573411,309730,219,438
219,0.75,0.818284,465764,219,438
220,0.125,0.173865,85424,220,440
220,0.25,0.298373,160217,220,440
220,0.5,0.639236,317103,220,440
220,0.75,0.985093,461598,220,440
221,0.125,0.165817,84710,221,442
221,0.25,0.293976,162740,221,442
221,0.5,0.57394,314960,221,442
221,0.75,0.887885,470549,221,442
222,0.125,0.175485,86658,222,444
222,0.25,0.308406,159877,222,444
222,0.5,0.706625,323815,222,444
222,0.75,0.90383,476977,222,444
223,0.125,0.186411,86663,223,446
223,0.25,0.316296,169495,223,446
223,0.5,0.599039,322712,223,446
223,0.75,1.018826,475834,223,446
224,0.125,0.20644,87857,224,448
224,0.25,0.40333,165005,224,448
224,0.5,0.630474,323434,224,448
224,0.75,1.252239,482313,224,448
225,0.125,0.184571,86676,225,450
225,0.25,0.406659,167731,225,450
225,0.5,0.71902,327358,225,450
225,0.75,1.245403,482235,225,450
226,0.125,0.438944,87381,226,452
226,0.25,0.386373,173461,226,452
226,0.5,0.691145,330315,226,452
226,0.75,1.25772,494190,226,452
227,0.125,0.260898,88032,227,454
227,0.25,0.736636,172214,227,454
227,0.5,0.828775,331892,227,454
227,0.75,1.172823,490735,227,454
228,0.125,0.202282,91966,228,456
228,0.25,0.610993,177295,228,456
228,0.5,0.752002,338596,228,456
228,0.75,1.412353,499710,228,456
229,0.125,0.215112,92404,229,458
229,0.25,0.389572,177201,229,458
229,0.5,0.873652,339300,229,458
229,0.75,1.337402,503273,229,458
230,0.125,0.218671,92319,230,460
230,0.25,0.363552,175771,230,460
230,0.5,0.89411,335242,230,460
230,0.75,1.136575,510728,230,460
231,0.125,0.208836,93587,231,462
231,0.25,0.388135,178604,231,462
231,0.5,0.890308,343779,231,462
231,0.75,1.208743,512351,231,462
232,0.125,0.221497,92305,232,464
232,0.25,0.392789,181253,232,464
232,0.5,0.805875,347733,232,464
232,0.75,1.19771,511777,232,464
233,0.125,0.395807,94267,233,466
233,0.25,0.393374,180814,233,466
233,0.5,0.937538,352617,233,466
233,0.75,1.659952,523145,233,466
234,0.125,0.246418,95954,234,468
234,0.25,0.493425,179357,234,468
234,0.5,0.795344,356480,234,468
234,0.75,1.448293,528547,234,468
235,0.125,0.244938,93741,235,470
235,0.25,0.428802,183073,235,470
235,0.5,0.970862,357418,235,470
235,0.75,1.178566,528493,235,470
236,0.125,0.198863,96703,236,472
236,0.25,0.412051,190346,236,472
236,0.5,0.84201,358304,236,472
236,0.75,1.306332,536368,236,472
237,0.125,0.229027,100067,237,474
237,0.25,0.432223,192070,237,474
237,0.5,0.974505,364307,237,474
237,0.75,1.378612,543123,237,474
238,0.125,0.217876,94086,238,476
238,0.25,0.474057,190011,238,476
238,0.5,1.095315,365385,238,476
238,0.75,1.456195,537023,238,476
239,0.125,0.324892,98568,239,478
239,0.25,0.431666,187060,239,478
239,0.5,0.88989,364941,239,478
239,0.75,1.195533,547798,239,478
240,0.125,0.247396,99905,240,480
240,0.25,0.500092,192019,240,480
240,0.5,1.398511,370750,240,480
240,0.75,1.482091,548509,240,480
241,0.125,0.301542,98980,241,482
241,0.25,0.47263,190699,241,482
241,0.5,1.296355,374865,241,482
241,0.75,1.860847,557252,241,482
242,0.125,0.294075,100434,242,484
242,0.25,0.486464,196665,242,484
242,0.5,1.008128,383460,242,484
242,0.75,1.437769,561147,242,484
243,0.125,0.234396,102686,243,486
243,0.25,0.535836,193173,243,486
243,0.5,0.927085,381209,243,486
243,0.75,1.478436,573635,243,486
244,0.125,0.273695,101554,244,488
244,0.25,0.508513,197910,244,488
244,0.5,1.14803,386288,244,488
244,0.75,1.45061,563981,244,488
245,0.125,0.307185,102598,245,490
245,0.25,0.643952,199647,245,490
245,0.5,1.04106,387169,245,490
245,0.75,1.482923,572889,245,490
246,0.125,0.416666,104105,246,492
246,0.25,0.539484,200831,246,492
246,0.5,0.939078,388863,246,492
246,0.75,1.280471,580783,246,492
247,0.125,0.2478,108009,247,494
247,0.25,0.766653,201314,247,494
247,0.5,0.94162,394949,247,494
247,0.75,1.765832,585753,247,494
248,0.125,0.345853,104578,248,496
248,0.25,0.655532,204906,248,496
248,0.5,0.98702,396048,248,496
248,0.75,2.326487,591416,248,496
249,0.125,0.295438,109330,249,498
249,0.25,0.5934,208572,249,498
249,0.5,1.021102,395649,249,498
249,0.75,1.522249,595779,249,498
250,0.125,0.269481,109098,250,500
250,0.25,0.524863,211639,250,500
250,0.5,1.218916,395765,250,500
250,0.75,1.743866,590213,250,500
251,0.125,0.275786,108567,251,502
251,0.25,0.943392,206118,251,502
251,0.5,1.211841,403871,251,502
251,0.75,1.844479,601464,251,502
252,0.125,0.365489,109932,252,504
252,0.25,0.512453,209920,252,504
252,0.5,0.940252,410839,252,504
252,0.75,1.610779,610964,252,504
253,0.125,0.289885,112114,253,506
253,0.25,0.550682,212908,253,506
253,0.5,1.073497,418333,253,506
253,0.75,1.632788,613849,253,506
254,0.125,0.496046,112471,254,508
254,0.25,0.627616,218301,254,508
254,0.5,1.320083,416652,254,508
254,0.75,1.685009,615878,254,508
255,0.125,0.300938,113853,255,510
255,0.25,0.535736,215876,255,510
255,0.5,1.546851,421569,255,510
255,0.75,1.835777,619209,255,510
256,0.125,0.27937,113392,256,512
256,0.25,0.568836,216893,256,512
256,0.5,1.015033,427435,256,512
256,0.75,1.670183,628686,256,512
